(
    snakes: [
        [
            ((1, 1, 2), (1, 0, 0)),
            ((0, 1, 2), (1, 0, 0)),
        ],
        [
            ((1, 1, 4), (1, 0, 0)),
            ((0, 1, 4), (1, 0, 0)),
        ],
    ],
    foods: [
        (7, 1, 5),
        (6, 1, 5),
        (5, 1, 5),
    ],
    walls: [
        (0, 0, 0),
        (2, 0, 2),
        (6, 1, 7),
        (4, 2, 2),
        (2, 0, 4),
        (2, 0, 5),
        (8, 1, 3),
        (7, 1, 2),
        (3, 0, 3),
        (8, 0, 9),
        (0, 0, 4),
        (1, 0, 2),
        (2, 0, 3),
        (2, 1, 7),
        (1, 0, 1),
        (3, 0, 2),
        (1, 0, 4),
        (6, 0, 8),
        (4, 0, 9),
        (6, 1, 3),
        (6, 0, 3),
        (9, 0, 2),
        (2, 0, 6),
        (4, 0, 4),
        (6, 0, 2),
        (3, 1, 3),
        (6, 0, 4),
        (4, 0, 6),
        (6, 0, 0),
        (5, 0, 6),
        (1, 0, 5),
        (7, 0, 2),
        (0, 0, 6),
        (1, 0, 8),
        (6, 2, 4),
        (9, 0, 6),
        (6, 1, 1),
        (8, 0, 1),
        (5, 0, 7),
        (7, 1, 4),
        (9, 0, 9),
        (4, 3, 6),
        (6, 1, 4),
        (7, 1, 8),
        (1, 0, 9),
        (4, 0, 3),
        (7, 0, 7),
        (3, 0, 1),
        (5, 1, 1),
        (5, 2, 2),
        (3, 0, 6),
        (8, 0, 5),
        (8, 0, 7),
        (9, 0, 7),
        (3, 0, 4),
        (4, 4, 7),
        (4, 0, 2),
        (4, 2, 3),
        (8, 0, 4),
        (7, 3, 2),
        (7, 0, 1),
        (5, 1, 8),
        (8, 1, 8),
        (6, 0, 5),
        (3, 0, 9),
        (5, 3, 1),
        (4, 1, 8),
        (4, 2, 4),
        (0, 0, 8),
        (7, 0, 5),
        (3, 0, 7),
        (4, 1, 4),
        (9, 0, 1),
        (8, 0, 0),
        (7, 0, 6),
        (9, 0, 3),
        (7, 0, 3),
        (0, 0, 1),
        (1, 0, 3),
        (3, 1, 2),
        (2, 0, 8),
        (5, 1, 4),
        (2, 2, 2),
        (8, 1, 7),
        (8, 1, 5),
        (3, 2, 7),
        (4, 1, 3),
        (4, 0, 5),
        (0, 0, 3),
        (8, 0, 8),
        (5, 0, 8),
        (4, 0, 7),
        (5, 0, 0),
        (9, 0, 8),
        (5, 0, 4),
        (5, 1, 3),
        (2, 0, 0),
        (4, 1, 7),
        (1, 0, 6),
        (4, 0, 1),
        (7, 0, 0),
        (8, 0, 3),
        (0, 0, 5),
        (3, 0, 8),
        (7, 0, 8),
        (2, 1, 8),
        (7, 1, 7),
        (1, 2, 5),
        (5, 0, 3),
        (4, 1, 5),
        (2, 0, 9),
        (1, 0, 7),
        (9, 0, 4),
        (6, 0, 1),
        (3, 1, 4),
        (4, 2, 5),
        (6, 2, 3),
        (9, 0, 0),
        (5, 0, 1),
        (4, 1, 2),
        (2, 0, 1),
        (6, 2, 5),
        (5, 2, 3),
        (3, 0, 5),
        (8, 0, 2),
        (7, 0, 4),
        (6, 2, 2),
        (8, 1, 4),
        (5, 0, 9),
        (4, 1, 1),
        (5, 2, 4),
        (5, 0, 5),
        (7, 1, 1),
        (9, 0, 5),
        (1, 0, 0),
        (4, 0, 8),
        (6, 0, 9),
        (7, 1, 3),
        (3, 1, 1),
        (3, 1, 5),
        (6, 1, 2),
        (1, 1, 3),
        (5, 2, 1),
        (0, 0, 9),
        (0, 0, 2),
        (8, 0, 6),
        (0, 0, 7),
        (5, 2, 5),
        (5, 1, 2),
        (6, 0, 7),
        (8, 2, 5),
        (6, 0, 6),
        (3, 1, 8),
        (3, 0, 0),
        (5, 0, 2),
        (2, 0, 7),
        (7, 2, 5),
        (6, 1, 8),
        (4, 0, 0),
        (7, 0, 9),
        (5, 1, 7),
        (5, 1, 9),
    ],
    spikes: [
        (10, 1, 10),
    ],
)