(
    snakes: [
        [
            ((1, 1, 0), (1, 0, 0)),
            ((0, 1, 0), (1, 0, 0)),
        ],
    ],
    foods: [
        (5, 1, 5),
    ],
    walls: [
        (5, 0, 7),
        (3, 0, 5),
        (9, 0, 4),
        (8, 0, 7),
        (2, 0, 0),
        (3, 0, 1),
        (7, 0, 0),
        (1, 0, 3),
        (2, 0, 9),
        (2, 0, 3),
        (3, 0, 9),
        (5, 0, 9),
        (9, 0, 3),
        (3, 0, 2),
        (2, 0, 6),
        (5, 0, 4),
        (9, 0, 2),
        (3, 0, 8),
        (5, 0, 3),
        (4, 0, 7),
        (0, 0, 0),
        (5, 0, 1),
        (8, 0, 3),
        (6, 0, 4),
        (8, 0, 8),
        (5, 0, 0),
        (6, 0, 3),
        (8, 0, 6),
        (1, 0, 0),
        (2, 0, 1),
        (9, 0, 5),
        (5, 0, 8),
        (8, 0, 5),
        (1, 0, 1),
        (0, 0, 2),
        (3, 0, 4),
        (1, 0, 4),
        (0, 0, 4),
        (4, 0, 4),
        (2, 0, 7),
        (1, 0, 6),
        (3, 0, 6),
        (8, 0, 0),
        (7, 0, 9),
        (4, 0, 1),
        (5, 0, 2),
        (0, 0, 5),
        (7, 0, 8),
        (7, 0, 1),
        (3, 0, 3),
        (0, 0, 8),
        (6, 0, 6),
        (7, 0, 2),
        (6, 0, 7),
        (7, 0, 3),
        (4, 0, 9),
        (4, 0, 8),
        (9, 0, 0),
        (0, 0, 3),
        (9, 0, 9),
        (1, 0, 2),
        (0, 0, 1),
        (5, 0, 6),
        (6, 0, 8),
        (0, 0, 6),
        (8, 0, 2),
        (2, 0, 5),
        (6, 0, 0),
        (1, 0, 5),
        (4, 0, 6),
        (7, 0, 5),
        (4, 0, 5),
        (7, 0, 7),
        (6, 0, 1),
        (3, 0, 7),
        (4, 0, 0),
        (8, 0, 9),
        (3, 0, 0),
        (4, 0, 2),
        (8, 0, 1),
        (9, 0, 1),
        (6, 0, 5),
        (1, 0, 9),
        (2, 0, 8),
        (6, 0, 2),
        (2, 0, 2),
        (9, 0, 6),
        (7, 0, 4),
        (6, 0, 9),
        (2, 0, 4),
        (9, 0, 7),
        (5, 0, 5),
        (0, 0, 7),
        (4, 0, 3),
        (8, 0, 4),
        (1, 0, 8),
        (7, 0, 6),
        (1, 0, 7),
        (0, 0, 9),
        (9, 0, 8),
    ],
)