(
    snakes: [
        [
            ((1, 1, 2), (1, 0, 0)),
            ((0, 1, 2), (1, 0, 0)),
        ],
    ],
    foods: [
        (6, 3, -1),
    ],
    walls: [
        (7, 2, -1),
        (7, 2, -2),
        (7, 0, -4),
        (4, 0, 2),
        (6, 0, 2),
        (5, 0, 2),
        (6, 1, -2),
        (6, 0, -2),
        (6, 0, 0),
        (7, 0, -3),
        (5, 0, -3),
        (7, 1, -3),
        (6, 0, 1),
        (5, 0, 1),
        (0, 0, -4),
        (1, 0, -4),
        (2, 0, -4),
        (3, 0, -4),
        (4, 0, -4),
        (7, 1, -4),
        (5, 0, -1),
        (6, 0, -4),
        (7, 1, -1),
        (3, 0, 2),
        (0, 0, -3),
        (1, 0, -3),
        (2, 0, -3),
        (3, 0, -3),
        (4, 0, -3),
        (6, 1, -4),
        (5, 0, 0),
        (6, 2, -2),
        (2, 0, 2),
        (6, 2, -1),
        (0, 0, -2),
        (1, 0, -2),
        (2, 0, -2),
        (3, 0, -2),
        (4, 0, -2),
        (6, 1, -3),
        (1, 0, 1),
        (3, 0, 1),
        (4, 0, 1),
        (7, 1, -2),
        (0, 0, -1),
        (1, 0, -1),
        (2, 0, -1),
        (3, 0, -1),
        (4, 0, -1),
        (6, 0, -3),
        (5, 0, -2),
        (7, 0, -1),
        (1, 0, 2),
        (2, 0, 1),
        (0, 0, 0),
        (1, 0, 0),
        (2, 0, 0),
        (3, 0, 0),
        (4, 0, 0),
        (6, 1, -1),
        (5, 0, -4),
        (7, 0, -2),
        (0, 0, 2),
        (6, 0, -1),
        (0, 0, 1),
        (0, 1, -3),
        (0, 1, -4),
        (1, 1, -4),
    ],
    spikes: [],
    boxes: [],
    triggers: [
        (2, 1, -1),
    ],
    goal: Some((4, 1, -1)),
)