(
    snakes: [
        [
            ((1, 1, 2), (1, 0, 0)),
            ((0, 1, 2), (1, 0, 0)),
        ],
    ],
    foods: [
        (0, 2, 9),
    ],
    walls: [
        (0, 0, 0),
        (2, 0, 2),
        (0, 0, 2),
        (8, 0, 2),
        (2, 0, 4),
        (2, 0, 5),
        (5, 0, 9),
        (7, 1, 2),
        (3, 0, 3),
        (8, 0, 9),
        (0, 0, 4),
        (1, 1, 9),
        (2, 0, 3),
        (3, 0, 0),
        (1, 0, 1),
        (3, 0, 2),
        (1, 0, 4),
        (6, 0, 8),
        (4, 0, 9),
        (6, 1, 3),
        (6, 0, 3),
        (9, 0, 2),
        (2, 0, 6),
        (4, 0, 4),
        (6, 0, 2),
        (6, 1, 0),
        (6, 0, 4),
        (4, 0, 6),
        (6, 0, 0),
        (5, 0, 6),
        (1, 0, 5),
        (7, 0, 2),
        (0, 0, 6),
        (1, 0, 8),
        (1, 0, 0),
        (9, 0, 6),
        (6, 1, 1),
        (8, 0, 1),
        (5, 0, 7),
        (3, 0, 5),
        (9, 0, 9),
        (6, 0, 9),
        (8, 1, 0),
        (7, 0, 4),
        (1, 0, 9),
        (4, 0, 3),
        (7, 0, 7),
        (3, 0, 1),
        (5, 1, 1),
        (7, 1, 3),
        (3, 0, 6),
        (8, 0, 5),
        (8, 0, 7),
        (9, 0, 7),
        (3, 0, 4),
        (8, 0, 6),
        (4, 0, 2),
        (5, 0, 5),
        (8, 0, 4),
        (5, 0, 2),
        (7, 0, 1),
        (8, 2, 0),
        (7, 0, 9),
        (6, 0, 5),
        (3, 0, 9),
        (2, 0, 7),
        (4, 0, 8),
        (9, 0, 5),
        (0, 0, 8),
        (7, 0, 5),
        (3, 0, 7),
        (7, 1, 1),
        (9, 0, 1),
        (8, 0, 0),
        (7, 0, 6),
        (9, 0, 3),
        (7, 0, 3),
        (0, 0, 1),
        (1, 0, 3),
        (6, 2, 0),
        (2, 0, 8),
        (2, 0, 1),
        (4, 0, 0),
        (6, 1, 2),
        (8, 2, 1),
        (0, 0, 7),
        (9, 2, 1),
        (4, 0, 5),
        (0, 0, 3),
        (8, 0, 8),
        (5, 0, 8),
        (4, 0, 7),
        (5, 0, 0),
        (9, 0, 8),
        (5, 0, 4),
        (5, 1, 3),
        (2, 0, 0),
        (6, 0, 7),
        (1, 0, 6),
        (4, 0, 1),
        (7, 0, 0),
        (8, 0, 3),
        (0, 0, 5),
        (3, 0, 8),
        (7, 0, 8),
        (6, 0, 6),
        (0, 0, 9),
        (5, 1, 2),
        (5, 0, 3),
        (5, 0, 1),
        (2, 0, 9),
        (1, 0, 7),
        (9, 0, 4),
        (6, 0, 1),
        (9, 0, 0),
        (5, 1, 0),
        (5, 2, 0),
        (7, 2, 0),
        (7, 1, 0),
        (9, 2, 0),
        (9, 1, 0),
        (5, 2, 3),
        (5, 2, 2),
        (5, 2, 1),
        (6, 2, 3),
        (6, 2, 2),
        (6, 2, 1),
        (7, 2, 1),
        (7, 2, 2),
        (7, 2, 3),
        (8, 1, 3),
        (8, 1, 2),
        (8, 1, 1),
        (9, 1, 1),
        (9, 1, 2),
        (9, 1, 3),
        (8, 2, 3),
        (9, 2, 3),
        (8, 2, 2),
        (9, 2, 2),
        (8, 1, 4),
        (9, 1, 4),
        (8, 2, 4),
        (9, 2, 4),
        (8, 1, 5),
        (9, 1, 5),
        (8, 2, 5),
        (9, 2, 5),
        (8, 1, 6),
        (9, 1, 6),
        (8, 2, 6),
        (9, 2, 6),
        (0, 1, 9),
        (0, 1, 8),
        (1, 1, 8),
        (1, 0, 2),
    ],
    spikes: [],
    triggers: [],
    boxes: [],
    goal: Some((8, 3, 1)),
)